a : ए
abandon : छोड़ देना
ability : योग्यता
able : योग्य
abortion : गर्भपात
about : के बारे में
above : के ऊपर
abroad : विदेश
absence : अनुपस्थिति
absolute : शुद्ध
absolutely : बिल्कुल
absorb : सोख लेना
abuse : गाली देना
academic : शैक्षिक
accept : स्वीकार करें
access : पहुंच
accident : दुर्घटना
accompany : साथ
accomplish : समाप्त करना
according : अनुसार
account : हेतु
accurate : शुद्ध
accuse : आरोप
achieve : प्राप्त करना
achievement : उपलब्धि
acid : अम्ल
acknowledge : स्वीकार करना
acquire : अधिग्रहण करना
across : आर - पार
act : कार्य
action : कार्य
active : सक्रिय
activist : कार्यकर्ता
activity : गतिविधि
actor : अभिनेता
actress : अभिनेत्री
actual : वास्तविक
actually : वास्तव में
ad : प्रति
adapt : अनुकूल बनाना
add : जोड़ें
addition : योग
additional : अतिरिक्त
address : पता
adequate : पर्याप्त
adjust : समायोजित करना
adjustment : समायोजन
administration : प्रशासन
administrator : प्रशासक
admire : प्रशंसा करना
admission : प्रवेश
admit : स्वीकार करना
adolescent : किशोर
adopt : अपनाने
adult : वयस्क
advance : अग्रिम
advanced : उन्नत
advantage : फायदा
adventure : साहसिक
advertising : विज्ञापन
advice : सलाह
advise : सलाह देना
adviser : सलाहकार
advocate : वकील
affair : मामला
affect : चाहना
afford : खर्च करना
afraid : डरा हुआ
African : अफ़्रीकी
African-American : अफ्रीकी अमेरिकी
after : उपरांत
afternoon : दोपहर
again : फिर
against : के खिलाफ
age : उम्र
agency : एजेंसी
agenda : कार्यसूची
agent : एजेंट
aggressive : आक्रामक
ago : पहले
agree : इस बात से सहमत
agreement : समझौता
agricultural : कृषि
ah : एएच
ahead : आगे
aid : सहायता
aide : सहायता
AIDS : एड्स
aim : लक्ष्य
air : वायु
aircraft : हवाई जहाज
airline : एयरलाइन
airport : हवाई अड्डा
album : एल्बम
alcohol : शराब
alive : जीवित
all : सब
alliance : गठबंधन
allow : अनुमति
ally : मित्र
almost : लगभग
alone : अकेला
along : साथ में
already : पहले से ही
also : भी
alter : उम्र
alternative : विकल्प
although : यद्यपि
always : हमेशा
AM : पूर्वाह्न
amazing : कमाल की
American : अमेरिकन
among : के बीच में
amount : रकम
analysis : विश्लेषण
analyst : विश्लेषक
analyze : विश्लेषण
ancient : प्राचीन
and : तथा
anger : क्रोध
angle : कोण
angry : गुस्सा
animal : जानवर
anniversary : सालगिरह
announce : की घोषणा
annual : वार्षिक
another : एक और
answer : उत्तर
anticipate : पूर्वानुमान करना
anxiety : चिंता
any : कोई भी
anybody : कोई
anymore : अब
anyone : किसी को
anything : कुछ भी
anyway : वैसे भी
anywhere : कहीं भी
apart : अलग
apartment : फ्लैट
apparent : स्पष्ट
apparently : प्रतीत होना
appeal : निवेदन
appear : के जैसा लगना
appearance : दिखावट
apple : सेब
application : आवेदन
apply : लागू
appoint : नियुक्त करना
appointment : नियुक्ति
appreciate : सराहना
approach : पहुंचना
appropriate : उपयुक्त
approval : अनुमोदन
approve : मंजूर
approximately : लगभग
Arab : अरब
architect : वास्तुकार
area : क्षेत्र
argue : लोगों का तर्क है
argument : तर्क
arise : उठता
arm : हाथ
armed : हथियारबंद
army : सेना
around : चारों तरफ
arrange : व्यवस्था
arrangement : व्यवस्था
arrest : गिरफ़्तार करना
arrival : आगमन
arrive : आना
art : कला
article : लेख
artist : कलाकार
artistic : कलात्मक
as : जैसा
Asian : एशियाई
aside : अलग
ask : पूछना
asleep : सुप्त
aspect : पहलू
assault : हमला करना
assert : ज़ोर
assess : आकलन
assessment : मूल्यांकन
asset : संपत्ति
assign : असाइन
assignment : कार्यभार
assist : सहायता देना
assistance : सहायता
assistant : सहायक
associate : सहयोगी
association : संगठन
assume : मान लीजिए
assumption : कल्पना
assure : आश्वासन
at : पर
athlete : एथलीट
athletic : पुष्ट
atmosphere : वायुमंडल
attach : संलग्न करें
attack : हमला
attempt : प्रयास
attend : भाग लेना
attention : ध्यान
attitude : रवैया
attorney : प्रतिनिधि
attract : आकर्षित
attractive : आकर्षक
attribute : गुण
audience : दर्शक
author : लेखक
authority : अधिकार
auto : ऑटो
available : उपलब्ध
average : औसत
avoid : टालना
award : पुरस्कार
aware : अवगत
awareness : जागरूकता
away : दूर
awful : भयंकर
baby : शिशु
back : वापस
background : पृष्ठभूमि
bad : बाद
badly : बुरी तरह
bag : थैला
bake : सेंकना
balance : संतुलन
ball : गेंद
ban : आधा
band : बंद
bank : बैंक
bar : बार
barely : मुश्किल से
barrel : बैरल
barrier : बैरियर
base : आधार
baseball : बेसबॉल
basic : बुनियादी
basically : मूल रूप से
basis : आधार
basket : टोकरी
basketball : बास्केटबाल
bathroom : स्नानघर
battery : बैटरी
battle : लड़ाई
be : होना
beach : सागरतट
bean : सेम
bear : भालू
beat : हराना
beautiful : सुंदर
beauty : सुंदरता
because : इसलिये
become : बनना
bed : बिस्तर
bedroom : शयनकक्ष
beer : बीयर
before : इससे पहले
begin : शुरू
beginning : शुरुआत
behavior : व्यवहार
behind : पीछे
being : हो रहा
belief : आस्था
believe : मानना
bell : घंटी
belong : संबंधित होना
below : नीचे
belt : बेल्ट
bench : बेंच
bend : झुकना
beneath : नीचे
benefit : फायदा
beside : पास
besides : के अतिरिक्त
best : श्रेष्ठ
bet : शर्त
better : बेहतर
between : के बीच
beyond : के परे
Bible : बाइबिल
big : बड़ा
bike : साइकिल
bill : विपत्र
billion : एक अरब
bind : बाँध
biological : जैविक
bird : चिड़िया
birth : जन्म
birthday : जन्मदिन
bit : अंश
bite : दांत से काटना
black : काला
blade : ब्लेड
blame : आरोप
blanket : कंबल
blind : अंधा
block : खंड मैथा
blood : रक्त
blow : फुंक मारा
blue : नीला
board : मंडल
boat : नाव
body : तन
bomb : बम
bombing : बम विस्फोट
bond : गहरा संबंध
bone : हड्डी
book : किताब
boom : बूम
boot : बीओओटी
border : बॉर्डर
born : जन्म
borrow : उधार
boss : मालिक
both : दोनों
bother : परेशानी
bottle : बोतल
bottom : तल
boundary : सीमा
bowl : कटोरा
box : डिब्बा
boy : लड़का
boyfriend : प्रेमी
brain : दिमाग
branch : डाली
brand : ब्रांड
bread : रोटी
break : तोड़ना
breakfast : सुबह का नाश्ता
breast : स्तन
breath : सांस
breathe : सांस लेना
brick : ईंट
bridge : पुल
brief : संक्षिप्त
briefly : संक्षिप्त
bright : चमकदार
brilliant : बहुत खूब
bring : लाओ
British : अंग्रेजों
broad : विस्तृत
broken : टूटा हुआ
brother : भाई
brown : भूरा
brush : ब्रश
buck : बक
budget : बजट
build : निर्माण
building : इमारत
bullet : गोली
bunch : झुंड
burden : बोझ
burn : जलाना
bury : गाड़
bus : बस
business : व्यापार
busy : व्यस्त
but : लेकिन
butter : मक्खन
button : बटन
buy : खरीदना
buyer : क्रेता
by : द्वारा
cabin : केबिन
cabinet : मंत्रिमंडल
cable : केबल
cake : केक
calculate : calculate
call : बुलाना
camera : कैमरा
camp : शिविर
campaign : अभियान
campus : कैंपस
can : कर सकते हैं
Canadian : कैनेडियन
cancer : कैंसर
candidate : उम्मीदवार
cap : टोपी
capability : क्षमता
capable : काबिल
capacity : क्षमता
capital : राजधानी
captain : कप्तान
capture : कब्जा
car : गाड़ी
carbon : कार्बन
card : कार्ड
care : कौन कौन से
career : आजीविका
careful : सावधान
carefully : सावधानी से
carrier : वाहक
carry : ढोना
case : मामला
cash : नकद
cast : ढालना
cat : बिल्ली
catch : पकड़
category : श्रेणी
Catholic : कैथोलिक
cause : वजह
ceiling : छत
celebrate : जश्न
celebration : उत्सव
celebrity : सेलिब्रिटी
cell : कक्ष
center : केंद्र
central : केंद्रीय
century : सदी
CEO : सीईओ
ceremony : समारोह
certain : कुछ
certainly : निश्चित रूप से
chain : जंजीर
chair : कुर्सी
chairman : अध्यक्ष
challenge : चुनौती
chamber : कक्ष
champion : चैंपियन
championship : चैंपियनशिप
chance : मोका
change : परिवर्तन
changing : बदलना
channel : चैनल
chapter : अध्याय
character : चरित्र
characteristic : विशेषता
characterize : विशेषताएँ
charge : चार्ज
charity : दान पुण्य
chart : चार्ट
chase : पीछा करना
cheap : सस्ता
check : जाँच
cheek : गाल
cheese : पनीर
chef : अध्यक्ष
chemical : रासायनिक
chest : छाती
chicken : मुर्गा
chief : अध्यक्ष
child : बच्चा
childhood : बचपन
Chinese : चीनी
chip : टुकड़ा
chocolate : चॉकलेट
choice : पसंद
cholesterol : कोलेस्ट्रॉल
choose : चुनें
Christian : ईसाई
Christmas : क्रिसमस
church : चर्च
cigarette : सिगरेट
circle : वृत्त
circumstance : परिस्थिति
cite : अदालत में तलब करना
citizen : नागरिक
city : शहर
civil : नागरिक
civilian : असैनिक
claim : दावा
class : कक्षा
classic : क्लासिक
classroom : कक्षा
clean : साफ
clear : स्पष्ट
clearly : स्पष्ट रूप से
client : ग्राहक
climate : जलवायु
climb : चढना
clinic : क्लिनिक
clinical : क्लीनिकल
clock : घड़ी
close : बंद करना
closely : निकट से
closer : करीब
clothes : कपड़े
clothing : कपड़े
cloud : बादल
club : क्लब
clue : संकेत
cluster : समूह
coach : कोच
coal : कोयला
coalition : गठबंधन
coast : कोस्ट
coat : कोट
code : कोड
coffee : कॉफ़ी
cognitive : संज्ञानात्मक
cold : सर्दी
collapse : ढहना
colleague : साथ काम करने वाला
collect : कलेक्ट
collection : संग्रह
collective : सामूहिक
college : महाविद्यालय
colonial : औपनिवेशिक
color : रंग
column : स्तंभ
combination : मेल
combine : जोड़ना
come : आइए
comedy : कॉमेडी
comfort : आराम
comfortable : आरामदायक
command : आदेश
commander : कमांडर
comment : टिप्पणी
commercial : व्यावसायिक
commission : आयोग
commit : प्रतिबद्ध
commitment : प्रतिबद्धता
committee : समिति
common : सामान्य
communicate : संवाद
communication : संचार
community : समुदाय
company : कंपनी
compare : तुलना करना
comparison : तुलना
compete : प्रतिस्पर्धा
competition : मुकाबला
competitive : प्रतियोगी
competitor : प्रतियोगी
complain : शिकायत
complaint : शिकायत
complete : पूर्ण
completely : पूरी तरह
complex : जटिल
complicated : जटिल
component : अवयव
compose : लिखें
composition : संयोजन
comprehensive : व्यापक
computer : संगणक
concentrate : ध्यान केंद्रित करना
concentration : एकाग्रता
concept : संकल्पना
concern : चिंता
concerned : चिंतित
concert : कंसर्ट
conclude : निष्कर्ष निकालना
conclusion : निष्कर्ष
concrete : ठोस
condition : स्थिति
conduct : आचरण
conference : सम्मेलन
confidence : आत्मविश्वास
confident : विश्वास है
confirm : पुष्टि करना
conflict : टकराव
confront : सामना होना
confusion : उलझन
Congress : कांग्रेस
congressional : कांग्रेस
connect : जुडिये
connection : संबंध
consciousness : चेतना
consensus : आम सहमति
consequence : परिणाम
conservative : अपरिवर्तनवादी
consider : विचार करना
considerable : विचारणीय
consideration : सोच - विचार
consist : बनावट
consistent : एक जैसा
constant : स्थिर
constantly : निरंतर
constitute : गठित करना
constitutional : संवैधानिक
construct : निर्माण
construction : निर्माण
consultant : सलाहकार
consume : उपभोग करना
consumer : उपभोक्ता
consumption : उपभोग
contact : संपर्क
contain : शामिल होना
container : पात्र
contemporary : समकालीन
content : विषय
contest : प्रतियोगिता
context : संदर्भ
continue : जारी रखें
continued : निरंतर
contract : अनुबंध
contrast : अंतर
contribute : योगदान
contribution : योगदान
control : नियंत्रण
controversial : विवादास्पद
controversy : विवाद
convention : सम्मेलन
conventional : पारंपरिक
conversation : बातचीत
convert : धर्मांतरित
conviction : दोषसिद्धि
convince : मनवाना
cook : रसोइया
cookie : कुकी
cooking : खाना बनाना
cool : ठंडा
cooperation : सहयोग
cop : पुलिस
cope : सामना
copy : प्रतिलिपि
core : सार
corn : मक्का
corner : कोने
corporate : निगमित
corporation : निगम
correct : सही
correspondent : संवाददाता
cost : कीमत
cotton : कपास
couch : सोफ़ा
could : सकता है
council : परिषद
counselor : काउंसलर
count : गिनती
counter : काउंटर
country : देश
county : काउंटी
couple : जोड़ा
courage : साहस
course : अवधि
court : कोर्ट
cousin : चचेरा भाई
cover : आवरण
coverage : कवरेज
cow : गाय
crack : दरार
craft : क्राफ्ट
crash : दुर्घटना
crazy : पागल
cream : मलाई
create : सृजन करना
creation : निर्माण
creative : रचनात्मक
creature : जंतु
credit : श्रेय
crew : कर्मी दल
crime : अपराध
criminal : आपराधिक
crisis : संकट
criteria : मानदंड
critic : समीक्षक
critical : नाजुक
criticism : आलोचना
criticize : आलोचना
crop : काटना
cross : पार करना
crowd : जन सैलाब
crucial : महत्वपूर्ण
cry : रोना
cultural : सांस्कृतिक
culture : संस्कृति
cup : कप
curious : जिज्ञासु
current : वर्तमान
currently : वर्तमान में
curriculum : पाठ्यक्रम
custom : रीति
customer : ग्राहक
cut : कट गया
cycle : चक्र
dad : पिता
daily : रोज
damage : क्षति
dance : नृत्य
danger : खतरा
dangerous : खतरनाक
dare : देने के लिए
dark : अंधेरा
darkness : अंधेरा
data : आंकड़े
date : दिनांक
daughter : बेटी
day : दिन
dead : मृत
deal : सौदा
dealer : विक्रेता
dear : प्रिय
death : मौत
debate : बहस
debt : कर्ज
decade : दशक
decide : निर्णय करना
decision : फैसला
deck : डेक
declare : घोषित
decline : पतन
decrease : कमी
deep : गहरा
deeply : गहरा
deer : मृग
defeat : परास्त करना
defend : रक्षा करना
defendant : प्रतिवादी
defense : रक्षा
defensive : बचाव
deficit : घाटा
define : परिभाषित करें
definitely : निश्चित रूप से
definition : परिभाषा
degree : डिग्री
delay : विलंब
deliver : उद्धार
delivery : वितरण
demand : मांग
democracy : जनतंत्र
Democrat : प्रजातंत्रवादी
democratic : लोकतांत्रिक
demonstrate : प्रदर्शन करना
demonstration : प्रदर्शन
deny : मना
department : विभाग
depend : निर्भर
dependent : आश्रित
depending : निर्भर करता है
depict : चित्रित
depression : डिप्रेशन
depth : गहराई
deputy : डिप्टी
derive : निकाले जाते हैं
describe : वर्णन करना
description : विवरण
desert : रेगिस्तान
deserve : योग्य होना
design : डिजाईन
designer : डिजाइनर
desire : मंशा
desk : डेस्क
desperate : बेकरार
despite : इसके बावजूद
destroy : नष्ट करना
destruction : विनाश
detail : विस्तार
detailed : विस्तृत
detect : पता लगाना
determine : ठानना
develop : विकसित करना
developing : विकसित होना
development : विकास
device : युक्ति
devote : समर्पित
dialogue : वार्ता
die : 
diet : आहार
differ : अलग होना
difference : अंतर
different : विभिन्न
differently : अलग ढंग से
difficult : कठिन
difficulty : कठिनाई
dig : आप
digital : डिजिटल
dimension : आयाम
dining : भोजन
dinner : रात का खाना
direct : सीधे
direction : दिशा
directly : सीधे
director : निर्देशक
dirt : गंदगी
dirty : गंदा
disability : विकलांगता
disagree : असहमत
disappear : गायब होना
disaster : आपदा
discipline : अनुशासन
discourse : प्रवचन
discover : डिस्कवर
discovery : खोज
discrimination : भेदभाव
discuss : चर्चा करें
discussion : विचार - विमर्श
disease : रोग
dish : थाली
dismiss : खारिज
disorder : विकार
display : प्रदर्शन
dispute : विवाद
distance : दूरी
distant : दूरस्थ
distinct : अलग
distinction : भेद
distinguish : अंतर करना
distribute : वितरित करना
distribution : वितरण
district : जिला
diverse : विविध
diversity : विविधता
divide : विभाजन
division : विभाजन
divorce : तलाक
DNA : गाउट
do : करना
doctor : चिकित्सक
document : डाक्यूमेंट
dog : कुत्ता
domestic : घरेलू
dominant : प्रमुख
dominate : हावी होना
door : के माध्यम से
double : दोहरा
doubt : शक
down : नीचे
downtown : शहर
dozen : दर्जन
draft : प्रारूप
drag : खींचना
drama : नाटक
dramatic : नाटकीय
dramatically : नाटकीय रूप से
draw : खींचना
drawing : चित्रकारी
dream : सपना
dress : पोशाक
drink : पीना
drive : चलाना
driver : चालक
drop : बूंद
drug : दवाई
dry : सूखा
due : देय
during : दौरान
dust : धूल
duty : कर्तव्य
each : प्रत्येक
eager : आतुर
ear : कान
early : शीघ्र
earn : कमाना
earnings : आय
earth : धरती
ease : आराम
easily : सरलता
east : पूर्व
eastern : पूर्व का
easy : आसान
eat : खाना खा लो
economic : आर्थिक
economics : अर्थशास्त्र
economist : अर्थशास्त्री
economy : अर्थव्यवस्था
edge : किनारा
edition : संस्करण
editor : संपादक
educate : शिक्षित
education : शिक्षा
educational : शिक्षात्मक
educator : शिक्षक
effect : प्रभाव
effective : प्रभावी
effectively : प्रभावी रूप से
efficiency : क्षमता
efficient : कुशल
effort : प्रयास
egg : अंडा
eight : आठ
either : दोनों में से एक
elderly : बुज़ुर्ग
elect : इलेक्ट्रोनिक
election : चुनाव
electric : बिजली
electricity : बिजली
electronic : इलेक्ट्रोनिक
element : तत्त्व
elementary : प्राथमिक
eliminate : हटाना
elite : अभिजात वर्ग
else : अन्य
elsewhere : कहीं
e-mail : ईमेल
embrace : अंगीकार करना
emerge : उभरना
emergency : आपातकालीन
emission : उत्सर्जन
emotion : भावना
emotional : भावुक
emphasis : ज़ोर
emphasize : ज़ोर देना
employ : काम
employee : कर्मचारी
employer : नियोक्ता
employment : रोज़गार
empty : खाली
enable : सक्षम
encounter : मुठभेड़
encourage : प्रोत्साहित करना
end : समाप्त
enemy : दुश्मन
energy : ऊर्जा
enforcement : प्रवर्तन
engage : काम पर लगाना
engine : यन्त्र
engineer : इंजीनियर
engineering : अभियांत्रिकी
English : अंग्रेज़ी
enhance : सुधारना
enjoy : का आनंद लें
enormous : विशाल
enough : पर्याप्त
ensure : सुनिश्चित करना
enter : दर्ज
enterprise : उद्यम
entertainment : मनोरंजन
entire : संपूर्ण
entirely : पूरी तरह से
entrance : प्रवेश
entry : प्रवेश
environment : वातावरण
environmental : पर्यावरण
episode : प्रकरण
equal : बराबरी का
equally : समान रूप से
equipment : उपकरण
era : था
error : त्रुटि
escape : पलायन
especially : विशेष रूप से
essay : निबंध
essential : आवश्यक
essentially : अनिवार्य रूप से
establish : स्थापित करना
establishment : स्थापना
estate : जायदाद
estimate : आकलन
etc : आदि
ethics : आचार विचार
ethnic : संजाति विषयक
European : यूरोपीय
evaluate : मूल्यांकन करना
evaluation : मूल्यांकन
even : यहाँ तक की
evening : शाम
event : प्रतिस्पर्धा
eventually : अंततः
ever : कभी
every : हर एक
everybody : हर
everyday : हर दिन
everyone : हर कोई
everything : हर चीज़
everywhere : हर जगह
evidence : सबूत
evolution : क्रमागत उन्नति
evolve : विकसित करना
exact : सटीक
exactly : बिल्कुल सही
examination : इंतिहान
examine : की जांच
example : उदाहरण
exceed : पार करना
excellent : अति उत्कृष्ट
except : के अलावा
exception : अपवाद
exchange : लेन देन
exciting : उत्तेजित करनेवाला
executive : कार्यपालक
exercise : व्यायाम
exhibit : प्रदर्शन
exhibition : प्रदर्शनी
exist : मौजूद
existence : अस्तित्व
existing : मौजूदा
expand : विस्तार
expansion : विस्तार
expect : अपेक्षा करना
expectation : अपेक्षा
expense : व्यय
expensive : महंगा
experience : अनुभव
experiment : प्रयोग
expert : विशेषज्ञ
explain : समझाना
explanation : व्याख्या
explode : विस्फोट
explore : अन्वेषण करना
explosion : विस्फोट
expose : अनावृत करना
exposure : अनावरण
express : व्यक्त करना
expression : अभिव्यक्ति
extend : विस्तार
extension : विस्तार
extensive : बहुत बड़ा
extent : क्षेत्र
external : बाहरी
extra : अतिरिक्त
extraordinary : असाधारण
extreme : चरम
extremely : अत्यंत
eye : आंख
fabric : कपड़ा
face : चेहरा
facility : सुविधा
fact : तथ्य
factor : फ़ैक्टर
factory : फ़ैक्टरी
faculty : संकाय
fade : मुरझाना
fail : विफल
failure : असफलता
fair : निष्पक्ष
fairly : काफी
faith : आस्था
fall : गिरना
false : असत्य
familiar : परिचित
family : परिवार
famous : प्रसिद्ध
fan : पंखा
fantasy : कल्पना
far : दूर
farm : खेत
farmer : किसान
fashion : फैशन
fast : तेज़
fat : मोटा
fate : भाग्य
father : पिता
fault : दोष
favor : एहसान
favorite : पसंदीदा
fear : डर
